NO   ./textures/brain_coral_block.XPM        
SO   ./textures/jukebox_side.XPM  
WE   ./textures/copper_ore.XPM   
EA   ./textures/crimson_stem_top.XPM   
	F   255 ,         0,    0 
	C   255 ,         0,    0 

       1111111111101111111111
       10010000011100000000011111
       1100000000000000000000000111
11111111110110000011100000000000011
11000000000110000011111111011111111
1111101111111111000000000000010000
111111111111111011101010010001111
1110000001101010111000000111111
1100000000000000000000000010011
1000000000000000001101010000011
111000001110101011111011110E01111
1111111111111111111111111111111
