NO   ./textures/brain_coral_block.XPM              
SO   ./textures/jukebox_side.XPM        
WE   ./textures/copper_ore.XPM              
EA   ./textures/crimson_stem_top.XPM              
F   220  , 100,  0
C     225   ,30,  0
111111111111111111111111111	
11111111111101100000111000000000
       1100100000000000000000000111
11111111110110000011100000000000011
11000000000110000011111111011111111
11111011111111110000000000000100011
111111111111111011101010010001111
1110000001101010111000000100011
1100000000000000000000000000011
10000000000000000011010100100011
111000001110101011111011110E01111
1111111111111111111111111111111
                            11
00000000111111111111111111111111111
11111111111101100000111000000000111
11001000000000000000000001111111111
11111111110110000011100000000000011
11000000000110000011111111111111111
11111011111111110000000000000100011
11111111111111101110101001000111111
11100000011010101110000001000111111
11000000000000000000000000000111111
10000000000000000011010100100011111
11100000111010101111101111000111111
11111111111111111111111111111111111
00000000000000000000000000000000000
00000000000000000000000000000000000
00000000000000000000000000000000000
00000000000000000000000000000000000
00000000000000000000000000000000000
00000000000000000000000000000000000